######################
######################
#  #     #    #      #
#  #     #    #  #   #
#  ###  ##########   #
#                    #
######   #           #
#    #   #           #
#    #   #           #
######   #############
#                    #
#   ###   ###  ###   #
#                    #
############   ##### #
#              #     #
#   ##################
#   ###         ######
#   ###   ###   ######
#         ###   ######
#         ###        #
###############      #
#S                   #
######################